
##############################
#         |                  #
#    0    |                  #
#         |                  #
#         |                  #
#                            #
#                            #
#                            #
#                            #
#                            #
##############################

